2222222222222222222
2111111111111111112
2111111111111111112
2111111111111111112
2111111111111111112
2111222222222221112
2111111111111111112
2111111111111111112
2222222222222222222